20000000
00000000
00000000
20220000
00022000
00000000
00000000
00000000
