00000000
00000000
00100000
00101000
00000000
00101100
00000000
00000000
