10101101
00000000
00000000
00000000
00000000
00000000
00000000
02020220
