21110000
11210000
11110020
00000000
00200000
00000000
00000000
00000000
