WWWWWWWWW
W       W
W W P W W
W       W
W W   W W
W  WWW  W
WWWWWWWWW