WWWWWWWWWWWW
W----------W
W-G--------W
W-------P--W
WWWWWWWWWWWW